new	fresh novel raw unexampled newfangled New Modern New young
other	early former
important	significant crucial authoritative
first	inaugural initiative initiatory maiden beginning foremost
economic	economical economical
possible	potential
same	like
own	ain
good	full estimable honorable respectable beneficial just upright adept expert practiced proficient skillful skilful dear near dependable safe secure right ripe well effective serious sound salutary honest undecomposed unspoiled unspoilt
social	societal
international	external outside
high	eminent gamey gamy mellow
free	complimentary costless gratis gratuitous detached spare barren destitute devoid innocent loose liberal
different	unlike dissimilar
great	outstanding bully corking cracking dandy groovy keen neat nifty peachy swell smashing capital majuscule big enceinte expectant gravid large heavy
financial	fiscal
able	capable
available	uncommitted usable useable
national	home interior internal
particular	peculiar special especial exceptional special special finical finicky fussy picky
last	concluding final terminal final net utmost final lowest
clear	open clean light unclouded unmortgaged clean decipherable readable absolved cleared exculpated exonerated vindicated percipient
common	mutual usual vernacular vulgar plebeian vulgar unwashed coarse coarse uncouth vulgar
small	little minor modest little humble low lowly modest little minuscule little modest belittled diminished
long	retentive recollective tenacious farseeing farsighted foresighted foresightful prospicient longsighted
large	big bombastic declamatory orotund tumid turgid big magnanimous big prominent big enceinte expectant gravid great heavy
best	better good full good good estimable good honorable respectable beneficial good good good just upright adept expert good practiced proficient skillful skilful good dear good near dependable good safe secure good right ripe good well effective good good good serious good sound good salutary good honest good undecomposed unspoiled unspoilt good
real	existent tangible actual genuine literal substantial material veridical
next	following adjacent future succeeding
legal	sound effectual
full	entire total total replete good broad wide
certain	sure sure sealed sure sure
main	chief primary principal master independent
special	particular peculiar especial exceptional particular limited particular extra
global	planetary world worldwide globose globular orbicular spheric spherical
various	assorted respective several diverse versatile
right	correct correct correct proper correct good ripe veracious
third	tertiary
general	cosmopolitan ecumenical oecumenical universal worldwide
single	individual unmarried individual undivided exclusive
better	best good full good good estimable good honorable respectable beneficial good good good just upright adept expert good practiced proficient skillful skilful good dear good near dependable good safe secure good right ripe good well effective good good good serious good sound good salutary good honest good undecomposed unspoiled unspoilt good well good well well
old	older erstwhile former onetime quondam sometime Old previous
several	respective various
modern	mod modernistic advanced innovative Modern New
private	individual secret
effective	effectual efficacious efficient good
open	unfastened exposed opened assailable undefendable undefended loose undecided undetermined unresolved opened receptive overt capable subject clear candid
little	small slight small fiddling footling lilliputian niggling piddling piffling petty picayune trivial small short minuscule small
difficult	hard unmanageable
short	little inadequate poor unretentive forgetful light scant shortsighted unforesightful myopic brusque brusk curt
greater	great great outstanding great bully corking cracking dandy great groovy keen neat nifty peachy swell smashing capital great majuscule big enceinte expectant gravid great large heavy
further	farther
excellent	fantabulous splendid
individual	single single private
recent	late
serious	dangerous grave grievous severe good unplayful sober
internal	intragroup home interior national inner interior inner intimate
essential	indispensable crucial substantive
technical	proficient technological expert
responsible	creditworthy
positive	convinced confident plus confirming prescribed incontrovertible irrefutable positivist positivistic electropositive cocksure overconfident
democratic	Democratic popular
whole	unharmed unhurt unscathed hale solid unanimous
cultural	ethnic ethnical
fundamental	cardinal central key primal rudimentary underlying profound
natural	instinctive raw rude born innate lifelike
only	lone lonesome sole solitary alone
young	immature new youthful vernal unseasoned untested untried
easy	easygoing leisurely gentle soft comfortable prosperous gentle light loose promiscuous sluttish wanton
foreign	strange alien extraneous
future	next succeeding
strong	potent potent stiff impregnable inviolable secure unassailable unattackable solid substantial hard warm firm
sure	certain certain certain certain trusted indisputable
key	cardinal central fundamental primal
TRUE	truthful dependable honest reliable genuine unfeigned lawful rightful straight
central	cardinal fundamental key primal
wide	broad blanket broad encompassing extensive panoptic broad spacious full
additional	extra
significant	important substantial meaning pregnant
aware	cognizant cognisant mindful
low	abject miserable scummy scurvy humble lowly modest small depleted broken crushed humbled humiliated gloomy grim blue depressed dispirited down downcast downhearted
final	concluding last terminal last net last
complete	consummate accomplished arrant consummate everlasting gross perfect pure sodding stark staring thoroughgoing utter unadulterated concluded ended over terminated
agricultural	agrarian farming
unique	alone unequaled unequalled unparalleled singular
nuclear	atomic
basic	canonic canonical introductory
direct	unmediated lineal verbatim
famous	celebrated famed illustrious notable noted renowned
big	large bad large prominent heavy boastful braggart bragging braggy crowing swelled vainglorious adult grown grownup large magnanimous bighearted bounteous bountiful freehanded handsome giving liberal openhanded enceinte expectant gravid great large heavy
entire	full total integral intact intact
huge	immense vast Brobdingnagian
active	fighting participating alive dynamic
higher	high high eminent high high high gamey gamy high high mellow
close	near nigh faithful tight confining airless stuffy unaired tight snug cheeseparing near skinny closelipped closemouthed secretive tightlipped
simple	elementary uncomplicated unproblematic bare mere childlike unsubdivided
civil	polite civic
previous	old former late premature
external	extraneous outside international outside
comfortable	comfy easy prosperous
total	entire full full
ideal	idealistic
latest  late recent later  previous
perfect	arrant complete consummate everlasting gross pure sodding stark staring thoroughgoing utter unadulterated
friendly	favorable
independent	autonomous sovereign main
French	Gallic
similar	alike like like exchangeable interchangeable standardized standardised
former	erstwhile old onetime quondam sometime late previous early other
fair	just fairish reasonable bonny bonnie comely sightly average mediocre middling clean honest fairish
efficient	effective
early	former other
hard	difficult knockout severe arduous backbreaking grueling gruelling heavy laborious operose punishing toilsome unvoiced voiceless surd concentrated intemperate heavy strong tough
due	ascribable imputable referable
largest	large big large bombastic declamatory large orotund tumid turgid big large magnanimous big large prominent large big enceinte expectant gravid great large heavy
popular	democratic pop
crucial	important essential
safe	dependable good secure
enough	adequate decent
double	dual twofold treble threefold dual duple doubled twofold bivalent forked
equal	adequate
Many	many
useful	utile utilitarian
highest	high high eminent high high high gamey gamy high high mellow
practical	hardheaded pragmatic virtual
subject	capable open dependent
historical	historic diachronic
annual	yearly
poor	hapless miserable misfortunate pathetic piteous pitiable pitiful wretched inadequate short
numerous	legion
medium	average intermediate
strategic	strategical
happy	felicitous glad
structural	geomorphologic geomorphological morphologic morphological morphologic morphological
ready	quick
innovative	advanced modern innovational groundbreaking
rich	fat fertile productive deep racy robust ample copious plenteous plentiful
vital	critical lively
interested	concerned
historic	historical
proper	right
official	prescribed
extra	excess redundant spare supererogatory superfluous supernumerary surplus special additional
past	preceding retiring
competitive	competitory militant
standard	received stock
critical	vital decisive
lower	low low low low low abject low miserable scummy scurvy humble low lowly modest small depleted low broken crushed humbled humiliated low gloomy grim blue depressed dispirited down downcast downhearted low
powerful	potent brawny hefty muscular sinewy herculean
very	identical selfsame
mobile	nomadic peregrine roving wandering fluid
broad	wide blanket encompassing extensive panoptic wide unspecific unsubtle full spacious wide liberal tolerant
nice	decent skillful dainty overnice prissy squeamish courteous gracious
monetary	pecuniary
wrong	incorrect improper amiss awry haywire incorrect unseasonable untimely faulty incorrect
suitable	suited desirable worthy
extensive	extended blanket broad encompassing panoptic wide
closed	shut unopen shut unsympathetic
green	greenish unripe unripened immature fleeceable gullible
quiet	restrained hushed muted subdued placid still tranquil smooth unruffled
detailed	elaborate elaborated
maximum	maximal
Chinese	Taiwanese Formosan
domestic	domesticated
humanitarian	humanist humanistic
medical aesculapian
likely	probable potential
fiscal	financial
fine	ok okay
concerned	interested implicated
minimum	minimal
bad	big tough spoiled spoilt regretful sorry uncollectible risky speculative unfit unsound forged defective
actual	existent genuine literal real factual
criminal	condemnable deplorable reprehensible vicious felonious
genuine	echt true unfeigned actual literal real
white	snowy blank clean whitened ashen blanched bloodless livid
daily	casual everyday
dangerous	unsafe grave grievous serious severe
flexible	flexile elastic pliable pliant whippy compromising conciliatory
negative	disconfirming damaging electronegative minus
larger	bigger large big large bombastic declamatory large orotund tumid turgid big large magnanimous big large prominent large big enceinte expectant gravid great large heavy
stable	static unchanging
exclusive	sole single undivided
limited	circumscribed modified special
peaceful	peaceable passive
separate	freestanding disjoined
clean	clear clear light unclouded fresh uncontaminating unobjectionable uninfected fair blank white sporting sporty sportsmanlike neat
correct	right right right right
immediate	contiguous prompt quick straightaway
regular	veritable even steady unconstipated even
unacceptable	impossible insufferable unsufferable unaccepted
impossible	inconceivable unimaginable insufferable unacceptable unsufferable
easier	easy easy easygoing leisurely easy easy easy gentle soft easy comfortable easy prosperous easy gentle easy easy light loose promiscuous sluttish wanton easy easy
urgent	pressing
enormous	tremendous
worth	deserving
fresh	bracing brisk refreshing refreshful tonic new novel sweet invigorated refreshed reinvigorated sweet unfermented clean unused impertinent impudent overbold smart saucy sassy wise
late	belated tardy recent later former previous
potential	possible likely
wonderful	fantastic grand howling marvelous marvellous rattling terrific tremendous wondrous
religious	spiritual
greatest	sterling superlative great great outstanding great bully corking cracking dandy great groovy keen neat nifty peachy swell smashing capital great majuscule big enceinte expectant gravid great large heavy
honourable	honorable ethical honorable
typical	distinctive
transparent	crystalline limpid lucid pellucid diaphanous filmy gauzy gossamer sheer vaporous vapourous cobwebby guileless
advanced	innovative modern sophisticated ripe advance
permanent	lasting
sensitive	sensible sore raw tender
reasonable	sensible fair fairish sane
ambitious	challenging
unable	ineffective ineffectual
substantial	significant substantive real material hearty satisfying solid square solid strong
warm	affectionate fond lovesome tender strong quick ardent
corporate	bodied corporal embodied incarnate collective incorporated
reliable    dependable
biggest	large big big bad big big big large prominent big heavy boastful braggart bragging braggy big crowing big swelled vainglorious adult big grown grownup big big large magnanimous big bighearted bounteous bountiful freehanded handsome giving liberal openhanded big enceinte expectant gravid great large heavy
acceptable	satisfactory
rapid	speedy
More	more more
red	reddish ruddy carmine cerise cherry crimson ruby scarlet crimson violent crimson reddened flushed
capable	open subject able
elegant	graceful refined
prepared	disposed fain inclined
black	bleak dim dark sinister calamitous disastrous fatal fateful blackened grim mordant bootleg contraband smuggled disgraceful ignominious inglorious opprobrious shameful smutty
spacious	broad wide roomy
deep	bass rich thick cryptic cryptical inscrutable mysterious mystifying abstruse recondite
light	unaccented weak clean clear unclouded lightsome tripping faint swooning lightheaded abstemious scant short idle lite wakeful easy loose promiscuous sluttish wanton
adequate	equal decent enough passable tolerable
mutual	common reciprocal
outstanding	prominent salient spectacular striking owing undischarged great
physical	forcible
technological	technical
accessible	approachable
average	mean ordinary fair mediocre middling intermediate medium modal median
consistent	reproducible coherent logical ordered uniform
primary	chief main principal master elementary elemental basal
hot	raging blistering spicy live
smaller	littler small little minor modest small little small small humble low lowly modest small little minuscule small little small small modest small belittled diminished small
Western	western western western westerly western
Most	most most
sound	healthy intelligent levelheaded good reasoned legal effectual heavy profound wakeless
qualified	certified restricted dependent dependant
secure	unafraid untroubled impregnable inviolable strong unassailable unattackable dependable good safe
southern	southerly southerly
fast	debauched degenerate degraded dissipated dissolute libertine profligate riotous flying quick firm immobile firm loyal truehearted
dynamic	dynamical active
temporary	impermanent irregular
alternative	alternate substitute
respective	several various
valuable	worthful
regulatory	regulative
contemporary	contemporaneous
Other	other other early former other other
constant	changeless invariant unvarying ceaseless incessant perpetual unceasing unremitting
massive	monolithic monumental
older	aged elderly senior elder old old old old old erstwhile former old onetime quondam sometime old Old previous old
heavy	fleshy overweight clayey cloggy lowering sullen threatening dense impenetrable big sonorous intemperate hard grave grievous weighty lumbering ponderous labored laboured arduous backbreaking grueling gruelling hard laborious operose punishing toilsome leaden profound sound wakeless big enceinte expectant gravid great large
Last	last last concluding final last terminal last last final last net last utmost final last last lowest
collective	corporate
automatic	automatonlike machinelike robotlike robotic reflex reflexive
willing	uncoerced unforced
Christian	christian
worse	worsened bad bad big bad tough bad spoiled spoilt regretful sorry bad bad uncollectible bad bad bad risky speculative bad unfit unsound bad bad bad forged bad defective
creative	originative
operational	functional usable useable operable operating
grateful	thankful
quick	speedy flying fast agile nimble spry ready immediate prompt straightaway warm
universal	cosmopolitan ecumenical oecumenical general worldwide
precise	accurate exact
ethnic	cultural ethnical heathen heathenish pagan
vast	huge immense Brobdingnagian
cheap	inexpensive brassy flash flashy garish gaudy gimcrack loud meretricious tacky tatty tawdry trashy bum cheesy chintzy crummy punk sleazy tinny chinchy chintzy
glad	happy beaming
exceptional	exceeding olympian prodigious surpassing especial particular special
Public	public public
bilateral	isobilateral
absolute	downright rank sheer infrangible inviolable
healthy	salubrious intelligent levelheaded sound goodly goodish hefty respectable sizable sizeable tidy
proud	gallant lofty majestic
constitutional	inbuilt inherent integral constituent constitutive organic
stronger	strong strong potent strong potent strong stiff impregnable inviolable secure strong unassailable unattackable solid strong substantial strong hard strong strong warm firm strong
intellectual	rational noetic cerebral
delighted	beguiled captivated charmed enthralled entranced
extreme	utmost uttermost
impressive	telling
Greek	Grecian Hellenic
strict	rigorous nonindulgent rigid stern exacting
Private	private private individual private secret private
judicial	juridical juridic discriminative
Such	such
eastern	easterly easterly
raw	natural rude naked crude sensitive sore tender bleak cutting unsanded new peeled
oral	unwritten
charming	magic magical sorcerous witching wizard wizardly
sexual	intimate
decisive	critical
excessive	inordinate undue unreasonable extravagant exuberant overweening
careful	heedful deliberate measured thrifty
convenient	commodious
longer	long long long retentive recollective long tenacious long long long farseeing farsighted foresighted foresightful prospicient long longsighted long
visible	seeable
legitimate	logical lawful licit
soft	delicate voiced sonant piano diffuse diffused indulgent lenient gentle easy gentle flabby flaccid cushy easygoing balmy mild subdued
northern	northerly northerly
outdoor	outside
closer	close close near close nigh close close faithful close tight close confining airless close stuffy unaired close tight close close close snug close cheeseparing close near skinny close closelipped closemouthed secretive tightlipped
solid	hearty satisfying square substantial strong substantial firm upstanding unanimous whole
familiar	conversant intimate
dependent	dependant qualified subordinate pendent pendant subject dependant hooked
left	leftover odd remaining unexpended
usual	common
remote	distant outside distant removed outback distant
firm	steadfast steady stiff unbendable unfaltering unshakable unwavering solid strong steady unfluctuating fast immobile loyal truehearted fast
convinced	positive confident
realistic	naturalistic
blue	bluish blueish gloomy grim depressed dispirited down downcast downhearted low blasphemous profane gamy gamey juicy naughty racy risque spicy aristocratic aristocratical gentle patrician puritanic puritanical dark dingy disconsolate dismal gloomy grim sorry drab drear dreary
cold	stale dusty frigid inhuman insensate
maritime	nautical marine
formal	conventional schematic courtly stately
extraordinary	sinful
weak	watery washy unaccented light fallible frail imperfect decrepit debile feeble infirm rickety sapless weakly faint
flat	level plane categoric categorical unconditional prostrate compressed bland flavorless flavourless insipid savorless savourless vapid bland monotone monotonic monotonous mat matt matte matted
live	unrecorded alive bouncy lively resilient springy hot alive
satisfied	quenched slaked
forthcoming	extroverted outgoing approaching coming upcoming
fantastic	antic fantastical grotesque grand howling marvelous marvellous rattling terrific tremendous wonderful wondrous wild fantastical
diverse various
Japanese	Nipponese
classic	classical
New	new fresh new novel raw new new unexampled new new newfangled new Modern new young new
western	westerly
ordinary	average
cosy	cozy snug
virtual	practical
wider	wide broad blanket broad encompassing extensive panoptic wide wide broad spacious wide wide wide full wide
stylish	fashionable fashionable
sensible	reasonable sensitive
brief	abbreviated
severe	terrible wicked hard knockout austere stark stern spartan dangerous grave grievous serious
well	good
artistic	aesthetic esthetic
fourth	quaternary
continuous	uninterrupted
worldwide	global planetary world cosmopolitan ecumenical oecumenical general universal
magnificent	brilliant glorious splendid
spectacular	dramatic striking outstanding prominent salient striking
liberal	broad tolerant big bighearted bounteous bountiful freehanded handsome giving openhanded free loose
diplomatic	diplomatical
integrated	incorporate incorporated merged unified structured
functional	usable useable operable operational running operative working
prior	anterior
accurate	exact precise
prime	premier choice prize quality select meridian
organic	constituent constitutional constitutive
ecological	ecologic ecologic bionomical bionomic
pure	arrant complete consummate everlasting gross perfect sodding stark staring thoroughgoing utter unadulterated saturated vestal virgin virginal virtuous
luxurious	epicurean luxuriant sybaritic voluptuary voluptuous deluxe gilded grand opulent princely sumptuous
worst	bad bad big bad tough bad spoiled spoilt regretful sorry bad bad uncollectible bad bad bad risky speculative bad unfit unsound bad bad bad forged bad defective
geographical	geographic geographic
net	nett final last
Asian	Asiatic
disabled	handicapped
poorest	hapless miserable misfortunate pathetic piteous pitiable pitiful poor wretched poor poor poor inadequate poor short poor
rare	rarefied rarified uncommon
electric	electrical galvanic galvanizing galvanising
unfair  unjust
Hungarian	Magyar
conventional	established formal schematic ceremonious
radical	extremist ultra revolutionary basal
coherent	consistent logical ordered logical lucid tenacious
dead	beat bushed numb deadened idle stagnant utter drained
everyday	mundane quotidian routine unremarkable workaday casual daily
inadequate	unequal poor short
slow	dense dim dull dumb obtuse boring deadening dull irksome tedious tiresome wearisome dull sluggish
experienced	experient
Islamic	Muslim Moslem
lovely	adorable endearing
satisfactory	acceptable
committed	attached
delicious	delightful delectable luscious scrumptious toothsome yummy
evident	apparent manifest patent plain unmistakable discernible observable
female	distaff
productive	generative fat fertile rich
Portuguese	Lusitanian
compact	heavyset stocky thick thickset compendious succinct summary
unnecessary	unneeded
compulsory	mandatory required
relative	comparative proportional
liable	apt nonimmune nonresistant unresistant
sovereign	autonomous independent supreme
tragic	tragical
musical	melodious melodic
square	straight hearty satisfying solid substantial straightforward straight straight
sole	exclusive lone lonesome only solitary
Best	best better best good full good good estimable good honorable respectable beneficial good good good just upright adept expert good practiced proficient skillful skilful good dear good near dependable good safe secure good right ripe good well effective good good good serious good sound good salutary good honest good undecomposed unspoiled unspoilt good
fewer	few
intelligent	healthy levelheaded sound reasoning thinking
objective	nonsubjective accusative documentary
romantic	romanticist romanticistic amatory amorous quixotic
mere	bare simple
apparent	evident manifest patent plain unmistakable ostensible seeming
federal	Union Federal
thorough	exhaustive thoroughgoing
renowned	celebrated famed famous illustrious notable noted
thermal	thermic caloric
empty	hollow vacuous
broader	wide broad blanket broad encompassing extensive panoptic wide broad unspecific broad unsubtle broad full broad spacious wide broad broad liberal tolerant
narrow	minute
near	close nigh nigh cheeseparing close skinny dear good approximate
mass	aggregate aggregated aggregative
sophisticated	advanced
sorry	regretful bad deplorable distressing lamentable pitiful sad meritless blue dark dingy disconsolate dismal gloomy grim drab drear dreary
favourable	favorable favorable favorable golden favorable lucky prosperous
amazing	astonishing awesome awful awing
secret	clandestine surreptitious undercover underground unavowed private hidden privy secluded confidential mysterious mystic mystical occult orphic
exact	accurate precise
uniform	unvarying consistent undifferentiated
honest	honorable dependable reliable true good fair
dramatic	spectacular striking
remarkable	singular noteworthy
earlier	earliest early early early former other early early early
wild	untamed violent baseless groundless idle unfounded unwarranted hazardous risky fantastic godforsaken waste crazy dotty gaga barbarian barbaric savage uncivilized uncivilised angry furious raging tempestuous
visual	ocular optic optical ocular
minor	nonaged underage venial modest small
dry	ironic ironical wry juiceless teetotal
High	high high eminent high high high gamey gamy high high mellow
ethical	honorable honourable
oldest	old old old old older erstwhile former old onetime quondam sometime old Old previous old
marine	nautical maritime
secondary	lowly petty subaltern
informal	loose cozy intimate
credible	believable
violent	wild fierce tearing vehement crimson red
dark	black sinister dour glowering glum moody morose saturnine sour sullen benighted obscure blue dingy disconsolate dismal gloomy grim sorry drab drear dreary colored coloured
terrible	awful dire direful dread dreaded dreadful fearful fearsome frightening horrendous horrific atrocious abominable awful dreadful painful unspeakable severe wicked frightful awful tremendous
electrical	electric
beneficial	good
bright	brilliant vivid smart burnished lustrous shining shiny undimmed brilliant hopeful promising
logical	legitimate coherent consistent ordered coherent lucid
superior	superscript ranking
stunning	arresting sensational
FALSE	mistaken delusive fake faux imitation simulated sour assumed fictitious fictive pretended sham untrue
classical   classic
smooth	politic suave bland fluent fluid liquid legato placid quiet still tranquil unruffled
bigger	larger large big big bad big big big large prominent big heavy boastful braggart bragging braggy big crowing big swelled vainglorious adult big grown grownup big big large magnanimous big bighearted bounteous bountiful freehanded handsome giving liberal openhanded big enceinte expectant gravid great large heavy
insufficient	deficient
Jewish	Judaic
optimal	optimum
middle	mediate center halfway midway
Roman	Romanic Romanist romish popish papist papistic papistical
systematic	taxonomic taxonomical
Several	several respective several various several
later	ulterior posterior late late belated late tardy late recent late late late former late previous
gross	porcine megascopic arrant complete consummate everlasting perfect pure sodding stark staring thoroughgoing utter unadulterated crude earthy vulgar crying egregious flagrant glaring rank
native	aboriginal
alone	lone lonely solitary only unique unequaled unequalled unparalleled
supplementary	auxiliary subsidiary supplemental supplemental
mandatory	compulsory required
viable	feasible executable practicable workable
fascinating	absorbing engrossing gripping riveting bewitching captivating enchanting enthralling entrancing
precious	cherished treasured wanted valued cute
lively	racy alert brisk merry rattling snappy spanking zippy bouncy live resilient springy vital
elderly	aged older senior
contrary	obstinate perverse wayward adverse
equivalent	tantamount
mental	genial
about	astir
splendid	glorious resplendent splendiferous excellent fantabulous brilliant glorious magnificent
dedicated	consecrated consecrate
united	joined
progressive	reformist
Iranian	Persian
intense	acute vivid
privileged	inside inner
medieval	mediaeval mediaeval gothic chivalric knightly
timely	seasonable
desirable	suitable worthy
unlikely	improbable improbable unbelievable unconvincing
outside	external extraneous outdoor external international remote away
tough	rugged toughened sturdy ruffianly bad hard baffling elusive knotty problematic problematical
Muslim	Moslem Islamic
dual	double duple double twofold treble threefold
comparable	corresponding like
Czech	Czechoslovakian
principal	chief main primary master
following	undermentioned next
lowest	last low low low low low abject low miserable scummy scurvy humble low lowly modest small depleted low broken crushed humbled humiliated low gloomy grim blue depressed dispirited down downcast downhearted low
integral	constitutional inbuilt inherent entire intact
senior	aged elderly older
ill	sick inauspicious ominous
smart	chic voguish bright fresh impertinent impudent overbold saucy sassy wise
worthy	desirable suitable
Indian	Amerind Amerindic
interactive	synergistic interactional
confident	convinced positive surefooted
Iraqi	Iraki
unfortunate	inauspicious
unusual	strange
partial	fond
academic	donnish pedantic
indirect	collateral
superb	brilliant
cross	transverse transversal thwartwise crabbed crabby fussy grouchy grumpy
unanimous	consentaneous consentient solid whole
utmost	extreme uttermost last farthermost farthest furthermost furthest uttermost
prestigious	esteemed honored
busy	fussy interfering meddlesome meddling officious busybodied engaged
biological	biologic
strange	unusual unknown foreign
Good	good full good good estimable good honorable respectable beneficial good good good just upright adept expert good practiced proficient skillful skilful good dear good near dependable good safe secure good right ripe good well effective good good good serious good sound good salutary good honest good undecomposed unspoiled unspoilt good
clearer	clear clear clear open clear clear clear clean clear light unclouded clear unmortgaged clear clear clear clean clear clear clear clear decipherable readable absolved clear cleared exculpated exonerated vindicated clear percipient
keen	acute discriminating incisive knifelike penetrating penetrative piercing sharp exquisite bully corking cracking dandy great groovy neat nifty peachy swell smashing cutting knifelike piercing stabbing lancinate lancinating
Free	free free complimentary costless free gratis gratuitous free detached free free spare free barren destitute devoid free innocent free loose liberal
inner	interior internal internal intimate inside privileged
tangible	touchable real palpable
interior	home internal national inner internal midland upcountry
unknown	nameless unidentified unnamed obscure unsung strange
sunny	cheery gay
cool	coolheaded nerveless
robust	racy rich
linguistic	lingual
delicate	fragile frail soft finespun ticklish touchy
decent	nice becoming comely decorous seemly adequate enough
blind	unsighted unreasoning
tropical	tropic tropic
underground	belowground clandestine secret surreptitious undercover
genetic	familial hereditary inherited transmitted transmissible genic genetical genetical
sandy	flaxen arenaceous sandlike
authentic	reliable unquestionable veritable
round	circular orotund rotund
unstable	precarious unsound fluid
identical	indistinguishable selfsame very monovular superposable
favourite	favorite favored favorite pet preferred preferent
preventive	preventative prophylactic preventative
profound	fundamental heavy sound wakeless unfathomed unplumbed unsounded
modest	small humble low lowly small meek mild minor small
optical	ocular optic visual ocular optic opthalmic
explicit	expressed denotative
prominent	outstanding salient spectacular striking big large
artificial	unreal contrived hokey stilted
ideological	ideologic
stringent	rigorous tight
opposite	paired diametric diametrical polar
dominant	prevailing prevalent predominant rife
ultra	extremist radical
Great	great great outstanding great bully corking cracking dandy great groovy keen neat nifty peachy swell smashing capital great majuscule big enceinte expectant gravid great large heavy
Full	full entire full total full total full replete full full good broad full wide full
mixed	assorted miscellaneous motley sundry interracial
sharp	crisp acuate acute needlelike acute discriminating incisive keen knifelike penetrating penetrative piercing astute shrewd tart shrill abrupt precipitous
Special	particular peculiar special special especial exceptional particular special special limited special particular special extra special
optimum	optimal
upcoming	approaching coming forthcoming
unlimited	limitless outright inexhaustible
incredible	unbelievable
favorite	favourite favored favourite pet preferred preferent
grand	expansive heroic august lordly deluxe gilded luxurious opulent princely sumptuous fantastic howling marvelous marvellous rattling terrific tremendous wonderful wondrous exalted elevated sublime lofty rarefied rarified idealistic distinguished imposing magisterial
graphic	graphical graphical lifelike pictorial vivid
minimal	minimum
wise	judicious heady knowing fresh impertinent impudent overbold smart saucy sassy
alive	live animated active alert awake live
Further	further farther
symbolic	symbolical emblematic emblematical symbolical
finest	fine ok okay fine fine fine fine fine
rigorous	strict stringent tight
procedural	adjective
adverse	inauspicious untoward contrary
Real	real existent real real real tangible actual genuine literal real real substantial real material real veridical real
Central	cardinal central fundamental key primal central
indispensable	essential
spiritual	religious unearthly apparitional ghostlike ghostly phantasmal spectral
sad	deplorable distressing lamentable pitiful sorry
disastrous	black calamitous fatal fateful
golden	aureate gilded gilt gold halcyon prosperous gold gilded fortunate favorable favourable lucky prosperous
countless	infinite innumerable innumerous multitudinous myriad numberless uncounted unnumberable unnumbered unnumerable
relaxing	restful reposeful
twin	duplicate matching twinned
tremendous	enormous fantastic grand howling marvelous marvellous rattling terrific wonderful wondrous frightful terrible awful
Latin	Romance
spare	trim excess extra redundant supererogatory superfluous supernumerary surplus free bare scanty plain bare unembellished unornamented
hazardous	risky wild
neutral	impersonal inert indifferent achromatic electroneutral
moderate	temperate restrained
cheaper	cheap inexpensive brassy cheap flash flashy garish gaudy gimcrack loud meretricious tacky tatty tawdry trashy bum cheap cheesy chintzy crummy punk sleazy tinny cheap chinchy chintzy
aggressive	belligerent
indigenous	autochthonal autochthonic autochthonous endemic
calm	unagitated serene tranquil
breathtaking	breathless
Romanian	Rumanian Roumanian
resistant	immune tolerant insubordinate resistive repellent
colonial	compound
distant	remote aloof upstage remote removed remote
Eastern	eastern eastern easterly eastern eastern easterly eastern
autonomous	independent sovereign
determined	dictated set compulsive driven
absurd	cockeyed derisory idiotic laughable ludicrous nonsensical preposterous ridiculous
super	ace crack tiptop topnotch tops
younger	young immature new young youthful vernal young young unseasoned untested untried young
specialized	specialised
corresponding	comparable like
guilty	hangdog shamefaced shamed
coordinated	interconnected unified matching
rational	intellectual noetic
safer	safe safe safe dependable good safe secure
Nordic	nordic
endless	eternal interminable dateless sempiternal
medicinal	medicative
costly	dear pricey pricy
tight	taut compressed mean mingy miserly close close besotted blotto crocked cockeyed fuddled loaded pissed pixilated plastered slopped sloshed smashed soaked soused sozzled squiffy stiff wet nasty rigorous stringent
outermost	outmost
innocent	guiltless innocuous impeccant sinless ingenuous unacquainted barren destitute devoid free
yellow	yellowish xanthous chicken chickenhearted yellowed scandalmongering sensationalistic jaundiced icteric
thin	lean slender sparse flimsy fragile slight tenuous
organised	organized unionized unionised
transnational	multinational
revolutionary	radical rotatory
silent	soundless still mum tacit understood unsounded dumb mute
fit	primed set
chemical	chemic
theoretical	theoretic
sweet	angelic angelical cherubic seraphic dulcet honeyed mellifluous mellisonant gratifying odoriferous odorous perfumed scented fresh fresh unfermented sugared sweetened
problematic	debatable problematical baffling elusive knotty problematical tough
sincere	earnest solemn
immense	huge vast Brobdingnagian
precautionary	precautional
worrying	distressing distressful disturbing perturbing troubling worrisome
understandable	apprehensible intelligible graspable perceivable
painful	afflictive sore atrocious abominable awful dreadful terrible unspeakable irritating
tiny	bantam diminutive lilliputian midget petite flyspeck
fragile	delicate frail flimsy slight tenuous thin
faster	fast fast fast fast fast debauched degenerate degraded dissipated dissolute libertine profligate riotous fast flying quick fast fast firm immobile firm loyal truehearted fast fast
male	manful manlike manly virile
extended	lengthy prolonged protracted elongated lengthened prolonged extensive
incorrect	wrong wrong faulty wrong
overwhelming	overpowering consuming
feasible	executable practicable viable workable
newest	new fresh new novel raw new new unexampled new new newfangled new New Modern New new young new
involved	mired Byzantine convoluted knotty tangled tortuous
conservative	cautious bourgeois materialistic
distinct	distinguishable discrete decided trenchant
weekly	hebdomadal hebdomadary
plain	apparent evident manifest patent unmistakable unpatterned sheer unmingled unmixed unvarnished bare spare unembellished unornamented homely
multinational	transnational
expert	adept good practiced proficient skillful skilful technical
complementary	complemental completing
continental	Continental
International	international external international outside
smallest	small little minor modest small little small small humble low lowly modest small little minuscule small little small small modest small belittled diminished small
reduced	decreased
bold	bluff sheer
back	hind hinder
preparatory	preparative propaedeutic
emotional	aroused excited
inappropriate	incompatible unfitting
communist	communistic
structured	integrated
like	similar same alike similar comparable corresponding
graphical	graphic graphic
pharmaceutical	pharmaceutic
confidential	secret
vertical	perpendicular erect upright
grave	sedate sober solemn dangerous grievous serious severe grievous heavy weighty
worried	disquieted distressed disturbed upset apprehensive
conscious	witting
definitive	unequivocal authoritative classical classic determinate
poorer	hapless miserable misfortunate pathetic piteous pitiable pitiful poor wretched poor poor poor inadequate poor short poor
brutal	barbarous cruel fell roughshod savage vicious unrelenting beastly bestial brute brutish
Small	small little minor modest small little small small humble low lowly modest small little minuscule small little small small modest small belittled diminished small
complimentary	costless free gratis gratuitous
legendary	fabled